FFFFFFFFFFFFFF
FBBBBBBBBBBBBF
FBBBBBBBBBBBBF
FBBBBBBBBBBBBF
F............F
F............F
F............F
F............F
F.....P......F
FFFFFFFFFFFFFF
