FFFFFFFFFFFFFF
F....BBBB....F
F....BBBB....F
F....BBBB....F
F....BBBB....F
F....BBBB....F
F............F
F............F
F.....P......F
FFFFFFFFFFFFFF
